1111111111111111111111111111111111
1P0000000AAAAAAAAAAAAAA00000000001
1000000000000000000000000000000001
10CC00CC0CCCCC0CC000000CCCCCCC0C01
10CC00CC0CCCCC0CC000000CCCCCCC0C01
10CC00CC0CC0000CC000000CC000CC0C01
10CC00CC0CC0000CC000000CC000CC0C01
10CC00CC0CC0000CC000000CC000CC0C01
10CCCCCC0CCCCC0CC000000CCCCCCC0C01
10CCCCCC0CCCCC0CC000000CCCCC000C01
10CC00CC0CC0000CC000000CC000000C01
10CC00CC0CC0000CC000000CC000000C01
10CC00CC0CC0000CC000000CC000000001
10CC00CC0CCCCC0CCCCCCC0CC000000C01
10CC00CC0CCCCC0CCCCCCC0CC000000C01
1000000000000000000000000000000001
1E00000000000000000000000000000001
1111111111111111111111111111111111